1 1 1 1 1 1 1 
1 4 0 0 0 0 1 
1 0 0 0 0 0 1 
1 0 0 0 1 8 1 
1 0 7 0 0 0 1 
1 0 0 0 4 1 1 
1 1 1 1 1 1 1 
