1 1 1 1 1 1 1 
1 0 1 8 1 0 1 
1 0 0 4 0 0 1 
1 0 0 0 0 0 1 
1 0 4 7 0 0 1 
1 0 0 0 0 0 1 
1 1 1 1 1 1 1 
