1 1 1 1 1 1 1 
1 0 0 0 0 1 1 
1 4 7 0 0 0 1 
1 0 0 0 0 0 1 
1 0 0 0 0 0 1 
1 0 0 0 8 4 1 
1 1 1 1 1 1 1 
