1 1 1 1 1 1 1 
1 0 0 7 8 0 1 
1 0 0 0 0 0 1 
1 4 4 0 0 0 1 
1 1 0 0 0 1 1 
1 0 0 0 0 0 1 
1 1 1 1 1 1 1 
