1 1 1 1 1 1 1 
1 0 0 0 0 0 1 
1 0 0 0 0 0 1 
1 7 1 4 0 0 1 
1 0 0 0 0 0 1 
1 0 0 0 8 4 1 
1 1 1 1 1 1 1 
