1 1 1 1 1 1 1 
1 0 0 4 0 0 1 
1 0 0 0 0 0 1 
1 0 7 0 0 0 1 
1 0 1 0 0 0 1 
1 0 0 4 8 0 1 
1 1 1 1 1 1 1 
