1 1 1 1 1 1 1 1 1 1 1 1 1 1 1 1 1 1 1 1 
1 3 2 2 2 1 4 4 1 1 1 1 1 1 1 1 1 1 1 1 
1 2 2 3 2 1 0 3 1 1 1 1 1 1 1 1 1 1 1 1 
1 2 2 2 2 1 0 0 1 2 2 0 0 0 0 0 0 0 0 1 
1 2 3 2 4 1 3 0 1 2 2 0 0 0 0 0 0 0 0 1 
1 2 2 2 2 1 0 0 1 2 2 0 1 1 1 1 1 1 0 1 
1 1 2 2 1 1 2 2 1 1 1 0 1 4 3 3 4 1 0 1 
1 0 0 0 3 0 0 0 0 0 0 0 1 0 0 0 0 1 0 1 
1 0 0 0 0 0 0 0 0 0 2 0 1 0 0 0 0 1 0 1 
1 0 8 0 0 0 1 1 1 0 2 0 1 0 5 0 0 1 7 1
1 0 0 0 0 0 0 0 0 0 2 0 0 0 0 0 0 1 7 1 
1 0 0 0 3 0 0 0 0 0 0 0 0 0 0 0 0 1 7 1 
1 1 2 2 1 1 2 2 1 0 0 0 1 1 1 1 1 1 1 1 
1 3 2 2 2 1 0 0 1 0 0 0 0 0 6 0 0 6 0 1 
1 2 2 2 2 1 3 0 1 0 0 4 0 0 4 0 0 4 0 1 
1 2 4 2 3 1 0 0 1 0 0 0 0 0 0 0 0 0 0 1 
1 3 2 2 2 1 0 3 1 0 0 0 0 0 0 0 0 0 0 1 
1 2 2 2 2 1 0 0 1 0 0 4 0 0 4 0 0 4 0 1 
1 1 2 3 2 1 4 4 1 0 0 0 0 0 0 0 0 0 0 1 
1 1 1 1 1 1 1 1 1 1 1 1 1 1 1 1 1 1 1 1 
