1 1 1 1 1 1 1 1 1 1 1 1 1 1 1 1 1 1 1 1 
1 0 0 0 0 2 0 0 2 4 2 2 0 2 3 0 2 0 2 1 
1 0 8 0 0 2 2 0 0 2 0 3 0 0 2 0 2 0 2 1
1 0 0 0 2 2 2 2 3 2 2 2 0 0 2 2 0 2 0 1 
1 1 1 1 1 1 1 1 1 1 1 1 1 1 1 1 0 0 0 1 
1 0 0 5 4 0 0 0 0 0 3 0 0 0 0 1 0 0 0 1 
1 0 0 0 0 0 3 0 0 0 0 0 5 4 0 1 0 6 0 1 
1 0 0 1 1 1 1 1 1 1 1 1 1 1 1 1 3 0 3 1 
1 0 0 1 4 0 3 0 0 0 3 0 0 0 3 0 0 0 0 1 
1 6 0 1 0 0 0 0 3 0 0 0 3 0 0 0 0 1 0 1 
1 0 0 1 0 0 1 1 1 1 1 1 1 1 1 1 0 1 0 1 
1 0 0 0 0 0 1 0 0 0 0 4 1 0 0 0 0 1 0 1 
1 0 0 6 0 6 1 0 0 1 6 0 1 0 0 1 0 1 0 1 
1 0 0 0 0 0 1 0 6 1 0 0 1 0 0 1 0 1 0 1 
1 1 1 1 0 0 1 4 0 1 3 0 0 0 6 1 0 1 0 1 
1 7 7 1 0 0 1 1 1 1 1 1 1 1 1 1 0 1 0 1 
1 7 7 1 4 0 0 0 0 0 5 0 0 0 0 0 4 1 0 1 
1 7 7 1 1 1 1 1 1 1 1 1 1 1 1 1 1 1 0 1 
1 0 0 0 0 0 0 2 2 2 2 2 2 0 0 0 0 0 0 1 
1 1 1 1 1 1 1 1 1 1 1 1 1 1 1 1 1 1 1 1 
